   
   NO                ./textures/WALL0.xpm
   
SO ./textures/WALL14.xpm





WE ./textures/WALL24.xpm
EA ./textures/WALL98_1.xpm


S ./textures/sky_lantern_PNG50.xpm
C 0,255  ,      255
F  255 ,     255   , 0
R 1500 1000

11111111111 1
10000N000001
100000000001
100012100001
111111111111
    121     
     1
