R 900 600

NO   ./textures/WALL0.xpm
SO ./textures/WALL14.xpm
WE ./textures/WALL24.xpm
EA ./textures/WALL98_1.xpm

S ./textures/Wolf3Dfinalpillar.xpm

C 255,       255         ,255
F 0 ,      130  ,      00000000000000000000000000000000000000000150

        1111111111111111111111111
  111   1000002000110000000000001
  101   1011000001110002010002001
  111   1001000000000000001000001
111111111011000001110002010002001
100000000011000001110111111111111             
11110111111111011100100010001
11110111111111011101010010001
11000000110101011100000010001  11111
10000000000000001100000010001  10001
10000000000000201101010010001  10001
110000011101010111110111100011 11111
11110111111111111111111111111
12222S22221
11111111111
