R 1000 600

NO   ./textures/WALL0.xpm
SO ./textures/WALL14.xpm
WE ./textures/WALL24.xpm
EA ./textures/WALL98_1.xpm
S ./textures/Wolf3Dfinalpillar.xpm

F 255,255,255

C 0,0,0

1111111111111
122222S222221
1222220222221
1222220222221
1222220222221
1222220222221
1222220222221
1222220222221
1222220222221
1222220222221
1222220222221
1222220222221
1222220222221
1222220222221
1222220222221
1222220222221
1222220222221
1222220222221
1222220222221
1222220222221
1222220222221
1222220222221
1222220222221
1222220222221
1222220222221
1222220222221
1222220222221
1222220222221
1222220222221
1222220222221
1222220222221
1222220222221
1222220222221
1222220222221
1222220222221
1222220222221
1222220222221
1222220222221
1222220222221
1222220222221
1222220222221
1222220222221
1222220222221
1222220222221
1222220222221
1222220222221
1222220222221
1222220222221
1222220222221
1222220222221
1222220222221
1222220222221
1222220222221
1222220222221
1222220222221
1222220222221
1222220222221
1222220222221
1222220222221
1222220222221
1222220222221
1222220222221
1222220222221
1222220222221
1222220222221
1222220222221
1222220222221
1222220222221
1222220222221
1222220222221
1222220222221
1222220222221
1222220222221
1222220222221
1222220222221
1222220222221
1222220222221
1222220222221
1222220222221
1222220222221
1222220222221
1222220222221
1222220222221
1222220222221
1222220222221
1222220222221
1222220222221
1222220222221
1222220222221
1222220222221
1222220222221
1222220222221
1222220222221
1222220222221
1222220222221
1222220222221
1222220222221
1222220222221
1222220222221
1222220222221
1222220222221
1222220222221
1222220222221
1222220222221
1222220222221
1222220222221
1222220222221
1222220222221
1222220222221
1222220222221
1222220222221
1222220222221
1222220222221
1222220222221
1222220222221
1222220222221
1222220222221
1222220222221
1222220222221
1222220222221
1222220222221
1222220222221
1222220222221
1222220222221
1222220222221
1222220222221
1222220222221
1222220222221
1222220222221
1222220222221
1222220222221
1222220222221
1222220222221
1222220222221
1222220222221
1222220222221
1222220222221
1222220222221
1222220222221
1222220222221
1222220222221
1222220222221
1222220222221
1222220222221
1222220222221
1222220222221
1222220222221
1222220222221
1222220222221
1222220222221
1222220222221
1222220222221
1222220222221
1222220222221
1222220222221
1222220222221
1222220222221
1222220222221
1222220222221
1222220222221
1222220222221
1222220222221
1222220222221
1222220222221
1222220222221
1222220222221
1222220222221
1222220222221
1222220222221
1222220222221
1222220222221
1222220222221
1222220222221
1222220222221
1222220222221
1222220222221
1222220222221
1222220222221
1222220222221
1222220222221
1222220222221
1222220222221
1222220222221
1222220222221
1222220222221
1222220222221
1222220222221
1222220222221
1222220222221
1222220222221
1222220222221
1222220222221
1222220222221
1222220222221
1222220222221
1222220222221
1222220222221
1222220222221
1222220222221
1222220222221
1222220222221
1222220222221
1222220222221
1222220222221
1222220222221
1222220222221
1222220222221
1222220222221
1222220222221
1222220222221
1222220222221
1222220222221
1222220222221
1222220222221
1222220222221
1222220222221
1222220222221
1222220222221
1222220222221
1222220222221
1222220222221
1222220222221
1222220222221
1222220222221
1222220222221
1222220222221
1222220222221
1222220222221
1222220222221
1222220222221
1222220222221
1222220222221
1222220222221
1222220222221
1222220222221
1222220222221
1222220222221
1222220222221
1222220222221
1222220222221
1222220222221
1222220222221
1222220222221
1222220222221
1222220222221
1222220222221
1222220222221
1222220222221
1222220222221
1222220222221
1222220222221
1222220222221
1222220222221
1222220222221
1222220222221
1222220222221
1222220222221
1222220222221
1222220222221
1222220222221
1222220222221
1222220222221
1222220222221
1222220222221
1222220222221
1222220222221
1222220222221
1222220222221
1222220222221
1222220222221
1222220222221
1222220222221
1222220222221
1222220222221
1222220222221
1222220222221
1222220222221
1222220222221
1222220222221
1222220222221
1222220222221
1222220222221
1222220222221
1222220222221
1222220222221
1222220222221
1222220222221
1222220222221
1222220222221
1222220222221
1222220222221
1222220222221
1222220222221
1222220222221
1222220222221
1222220222221
1222220222221
1222220222221
1222220222221
1222220222221
1222220222221
1222220222221
1222220222221
1222220222221
1222220222221
1222220222221
1222220222221
1222220222221
1222220222221
1222220222221
1222220222221
1222220222221
1222220222221
1222220222221
1222220222221
1222220222221
1222220222221
1222220222221
1222220222221
1222220222221
1222220222221
1222220222221
1222220222221
1222220222221
1222220222221
1222220222221
1222220222221
1222220222221
1222220222221
1222220222221
1222220222221
1222220222221
1222220222221
1222220222221
1222220222221
1222220222221
1222220222221
1222220222221
1222220222221
1222220222221
1222220222221
1222220222221
1222220222221
1222220222221
1222220222221
1222220222221
1222220222221
1222220222221
1222220222221
1222220222221
1222220222221
1222220222221
1222220222221
1222220222221
1222220222221
1222220222221
1222220222221
1222220222221
1222220222221
1222220222221
1222220222221
1222220222221
1222220222221
1222220222221
1222220222221
1222220222221
1222220222221
1222220222221
1222220222221
1222220222221
1222220222221
1222220222221
1222220222221
1222220222221
1222220222221
1222220222221
1222220222221
1222220222221
1222220222221
1222220222221
1222220222221
1222220222221
1222220222221
1222220222221
1222220222221
1222220222221
1222220222221
1222220222221
1222220222221
1222220222221
1222220222221
1222220222221
1222220222221
1222220222221
1222220222221
1222220222221
1222220222221
1222220222221
1222220222221
1222220222221
1222220222221
1222220222221
1222220222221
1222220222221
1222220222221
1222220222221
1222220222221
1222220222221
1222220222221
1222220222221
1222220222221
1222220222221
1222220222221
1222220222221
1222220222221
1222220222221
1222220222221
1222220222221
1222220222221
1222220222221
1222220222221
1222220222221
1222220222221
1222220222221
1222220222221
1222220222221
1222220222221
1222220222221
1222220222221
1222220222221
1222220222221
1222220222221
1222220222221
1222220222221
1222220222221
1222220222221
1222220222221
1222220222221
1222220222221
1222220222221
1222220222221
1222220222221
1222220222221
1222220222221
1222220222221
1222220222221
1222220222221
1222220222221
1222220222221
1222220222221
1222220222221
1222220222221
1222220222221
1222220222221
1222220222221
1222220222221
1222220222221
1222220222221
1222220222221
1222220222221
1222220222221
1222220222221
1222220222221
1222220222221
1222220222221
1222220222221
1222220222221
1222220222221
1222220222221
1222220222221
1222220222221
1222220222221
1222220222221
1222220222221
1222220222221
1222220222221
1222220222221
1222220222221
1222220222221
1222220222221
1222220222221
1222220222221
1222220222221
1222220222221
1222220222221
1222220222221
1222220222221
1222220222221
1222220222221
1222220222221
1222220222221
1222220222221
1222220222221
1222220222221
1222220222221
1222220222221
1222220222221
1222220222221
1222220222221
1222220222221
1222220222221
1222220222221
1222220222221
1222220222221
1222220222221
1222220222221
1222220222221
1222220222221
1222220222221
1222220222221
1222220222221
1222220222221
1222220222221
1222220222221
1222220222221
1222220222221
1222220222221
1222220222221
1222220222221
1222220222221
1222220222221
1222220222221
1222220222221
1222220222221
1222220222221
1222220222221
1222220222221
1222220222221
1222220222221
1222220222221
1222220222221
1222220222221
1222220222221
1222220222221
1222220222221
1222220222221
1222220222221
1222220222221
1222220222221
1222220222221
1222220222221
1222220222221
1222220222221
1222220222221
1222220222221
1222220222221
1222220222221
1222220222221
1222220222221
1222220222221
1222220222221
1222220222221
1222220222221
1222220222221
1222220222221
1222220222221
1222220222221
1222220222221
1222220222221
1222220222221
1222220222221
1222220222221
1222220222221
1222220222221
1222220222221
1222220222221
1222220222221
1222220222221
1222220222221
1222220222221
1222220222221
1222220222221
1222220222221
1222220222221
1222220222221
1222220222221
1222220222221
1222220222221
1222220222221
1222220222221
1222220222221
1222220222221
1222220222221
1222220222221
1222220222221
1222220222221
1222220222221
1222220222221
1222220222221
1222220222221
1222220222221
1222220222221
1222220222221
1222220222221
1222220222221
1222220222221
1222220222221
1222220222221
1222220222221
1222220222221
1222220222221
1222220222221
1222220222221
1222220222221
1222220222221
1222220222221
1222220222221
1222220222221
1222220222221
1222220222221
1222220222221
1222220222221
1222220222221
1222220222221
1222220222221
1222220222221
1222220222221
1222220222221
1222220222221
1222220222221
1222220222221
1222220222221
1222220222221
1222220222221
1222220222221
1222220222221
1222220222221
1222220222221
1222220222221
1222220222221
1222220222221
1222220222221
1222220222221
1222220222221
1222220222221
1222220222221
1222220222221
1222220222221
1222220222221
1222220222221
1222220222221
1222220222221
1222220222221
1222220222221
1222220222221
1222220222221
1222220222221
1222220222221
1222220222221
1222220222221
1222220222221
1222220222221
1222220222221
1222220222221
1222220222221
1222220222221
1222220222221
1222220222221
1222220222221
1222220222221
1222220222221
1222220222221
1222220222221
1222220222221
1222220222221
1222220222221
1222220222221
1222220222221
1222220222221
1222220222221
1222220222221
1222220222221
1222220222221
1222220222221
1222220222221
1222220222221
1222220222221
1222220222221
1222220222221
1222220222221
1222220222221
1222220222221
1222220222221
1222220222221
1222220222221
1222220222221
1222220222221
1222220222221
1222220222221
1222220222221
1222220222221
1222220222221
1222220222221
1222220222221
1222220222221
1222220222221
1222220222221
1222220222221
1222220222221
1222220222221
1222220222221
1222220222221
1222220222221
1222220222221
1222220222221
1222220222221
1222220222221
1222220222221
1222220222221
1222220222221
1222220222221
1222220222221
1222220222221
1222220222221
1222220222221
1222220222221
1222220222221
1222220222221
1222220222221
1222220222221
1222220222221
1222220222221
1222220222221
1222220222221
1222220222221
1222220222221
1222220222221
1222220222221
1222220222221
1222220222221
1222220222221
1222220222221
1222220222221
1222220222221
1222220222221
1222220222221
1222220222221
1222220222221
1222220222221
1222220222221
1222220222221
1222220222221
1222220222221
1222220222221
1222220222221
1222220222221
1222220222221
1222220222221
1222220222221
1222220222221
1222220222221
1222220222221
1222220222221
1222220222221
1222220222221
1222220222221
1222220222221
1222220222221
1222220222221
1222220222221
1222220222221
1222220222221
1222220222221
1222220222221
1222220222221
1222220222221
1222220222221
1222220222221
1222220222221
1222220222221
1222220222221
1222220222221
1222220222221
1222220222221
1222220222221
1222220222221
1222220222221
1222220222221
1222220222221
1222220222221
1222220222221
1222220222221
1222220222221
1222220222221
1222220222221
1222220222221
1222220222221
1222220222221
1222220222221
1222220222221
1222220222221
1222220222221
1222220222221
1222220222221
1222220222221
1222220222221
1222220222221
1222220222221
1222220222221
1222220222221
1222220222221
1222220222221
1222220222221
1222220222221
1222220222221
1222220222221
1222220222221
1222220222221
1222220222221
1222220222221
1222220222221
1222220222221
1222220222221
1222220222221
1222220222221
1222220222221
1222220222221
1222220222221
1222220222221
1222220222221
1222220222221
1222220222221
1222220222221
1222220222221
1222220222221
1222220222221
1222220222221
1222220222221
1222220222221
1222220222221
1222220222221
1222220222221
1222220222221
1222220222221
1222220222221
1222220222221
1222220222221
1222220222221
1222220222221
1222220222221
1222220222221
1222220222221
1222220222221
1222220222221
1222220222221
1222220222221
1222220222221
1222220222221
1222220222221
1222220222221
1222220222221
1222220222221
1222220222221
1222220222221
1222220222221
1222220222221
1222220222221
1222220222221
1222220222221
1222220222221
1222220222221
1222220222221
1222220222221
1222220222221
1222220222221
1222220222221
1222220222221
1222220222221
1222220222221
1222220222221
1222220222221
1222220222221
1222220222221
1222220222221
1222220222221
1222220222221
1222220222221
1222220222221
1222220222221
1222220222221
1222220222221
1222220222221
1222220222221
1222220222221
1222220222221
1222220222221
1222220222221
1222220222221
1222220222221
1222220222221
1222220222221
1222220222221
1222220222221
1222220222221
1222220222221
1222220222221
1222220222221
1222220222221
1222220222221
1222220222221
1222220222221
1222220222221
1222220222221
1222220222221
1222220222221
1222220222221
1222220222221
1222220222221
1222220222221
1222220222221
1222220222221
1222220222221
1222220222221
1222220222221
1222220222221
1222220222221
1222220222221
1222220222221
1222220222221
1222220222221
1222220222221
1222220222221
1222220222221
1222220222221
1222220222221
1222220222221
1222220222221
1222220222221
1222220222221
1222220222221
1222220222221
1222220222221
1222220222221
1222220222221
1222220222221
1222220222221
1222220222221
1222220222221
1222220222221
1222220222221
1222220222221
1222220222221
1222220222221
1222220222221
1222220222221
1222220222221
1222220222221
1222220222221
1222220222221
1222220222221
1222220222221
1222220222221
1222220222221
1222220222221
1222220222221
1222220222221
1222220222221
1222220222221
1222220222221
1222220222221
1222220222221
1222220222221
1222220222221
1222220222221
1222220222221
1222220222221
1222220222221
1222220222221
1222220222221
1222220222221
1222220222221
1222220222221
1222220222221
1222220222221
1222220222221
1222220222221
1222220222221
1222220222221
1222220222221
1222220222221
1222220222221
1222220222221
1222220222221
1222220222221
1222220222221
1222220222221
1222220222221
1222220222221
1222220222221
1222220222221
1222220222221
1222220222221
1222220222221
1222220222221
1222220222221
1222220222221
1222220222221
1222220222221
1222220222221
1111111111111
