R 19512581982515015 000000000000000000000153185151959125981259

NO   ./textures/WALL0.xpm
SO ./textures/WALL14.xpm
WE ./textures/WALL24.xpm
EA ./textures/WALL98_1.xpm

S ./textures/Wolf3Dfinalpillar.xpm

F 0, 130 ,150
C 255,    255,         255

11111111111
12222S22221
12222022221
12222022221
12222022221
12222022221
12222022221
12222022221    1
12222022221   12111
12222022221    1101
12222022221     111
12222022221
12222022221
11111111111
