R 900 600

NO   ./textures/WALL0.xpm
SO ./textures/WALL14.xpm
WE ./textures/WALL24.xpm
EA ./textures/WALL98_1.xpm

S ./textures/Wolf3Dfinalpillar.xpm

C 255,       255         ,255
F 0 ,      130  ,      00000000000000000000000000000000000000000150

11111111111
12222S22221
12222022221
12222022221
12222022221
12222022221
12222022221
12222022221
12222022221     111
12222022221     101
12222022221     111
12222022221
12222022221
11111111111
