R 1920 1500

NO   ./textures/WALL0.xpm
SO ./textures/WALL14.xpm
WE ./textures/WALL24.xpm
EA ./textures/WALL98_1.xpm
S ./textures/Wolf3Dfinalpillar.xpm



C 255,       255         ,255

F 102 ,      130  ,      150

        1111111111111111111111111
  111   1000000000110000000000001
  101   1011000001110002010002001
  111   100100W000000000001000001
111111111011000001110002010002001
100000000011000001110111111111111
11110111111111011100000010001
11110111111111011101010010001
11000000110101011100000010001  11111
10000000000000001100000010001  10001
10000000000000001101010010001  10001
110000011101010111110111100011 11111
10000000000000000000000000001
10000000000000000000000000001
10000000000000000000000000001
10000000000000000000000000001
10000000000000000000000000001
10000000000000000000000000001
10000000000000000000000000001
10000000000000000000000000001
10000000000000000000000000001
10000000000000000000000000001
10000000000000000002000000001
10000000000000000002000000001
10000000000000000002000000001
10000000000000000002000000001
10000000000000000002000000001
10000000000000000002000000001
10000000000000000002000000001
10000000000000000002000000001
10000000000000000000000000001
10000000000000000000000000001
10000000000000000000000000001
10000000000000000000000000001
10000000000000000000000000001
10000000000000000000000000001
11111111111111111111111111111
