   
   NO                ./textures/WALL0.xpm
   
SO ./textures/WALL14.xpm


     


WE ./textures/WALL24.xpm
EA ./textures/WALL98_1.xpm


S               ./textures/wolf_pillar.xpm
C 0,255  ,      255
F  255 ,     255   , 0
R 1000 1000   

              111111111111
              100000000001
              100000000001
              1N2222222221
              122222222221
              122222222221
11111111111111000000000001
10000000000000000000000011
11111111111111111111111111
   1
111111111111
100012100001
111111111111
    101     
     1
