R 1024 720

F 220,100,0,
C ,,,,225,        30         ,0

NO ./textures/WALL0.xpm
SO ./textures/WALL14.xpm
WE ./textures/WALL24.xpm
EA ./textures/WALL98_1.xpm
S ./textures/Wolf3Dfinalpillar.xpm


        1111111111111111111111111
        1000000000112222222222221
        1011000001112222222222221
        1001000000022222222222221
111111111011000001110000000000001
100000000011000001110111110111111
11110111111111011100000010001
11110111111111011101010010001
11000000110101011100000010001
10002000000000001100000010001
10000000000000001101010010001
11000001110101011111011110N0111
11110111 1110101 101111010001
11111111 1111111 111111111111
