                WE              ./textures/WALL0.xpm

             SO                         ./textures/WALL14.xpm
                      F                 122,122,122
                                 NO ./textures/WALL24.xpm
                                         S          ./textures/WALL46.xpm
                                                                    R           1080                  720
                                                      EA                  ./textures/WALL69.xpm

                          C                      255,200,160
11111111111111111
10000000000000001
10200000200000201
10000000000000001
10002000200020001
10000000000000001
10202020N02020201
10000000000000001
10002000200200001
10000000000000001
10200000200002001
1000000000000001
11111111111111111
0
